6,6
######
# # ##
#   S#
# # ##
# E  #
######
