100,100
####################################################################################################
#  ###      ###  ##   ### # #     ## #  ##   # #      ########     # #       ##   #  #     ####  # #
## #  ######  #  #       ## #      #        ###  #   #  #     #  ##   ## ## #       ## ## # #  #####
#       #      #  ##   #    #  ##   # #     # #### #     ### ##  ## ##        ## ## # ##  #        #
#  #    ##  # ###   ###        #  ###  #  #   #  #     ##  # # #     ##   #    # ##  # ###    #   ##
# #      ##     ####   #   ### ##     # #  #  ## # ##  #        ## ##         ##     #    #        #
## ##     ##  #  ##   #  ##   #           #   ##  # #  ##  #  #   ###    # # # #  # ### # #  # ## ##
###  #   #           # #  ###   # #     #    ##    #    # # #     #  #  #   ### ##         #    #  #
# # #      #  ######  ## # #       #  #     #    #    ## ## # ###  #   # ##        #     # ##    # #
#             #  #   ###     # #  ## ####    #       # #    #   ### #   ## # ##    # ## #     #  # #
## #  ### # #   #  ## ##     #             #       ###     #   #  #  ##### #  #      # # ##  ##    #
### # #  #  #        #     # #     #  #         # # # # #    ##     # #    #  ##         #        ##
#    #                 # ## #  #   ##     # #    #   #      ###    #         #    #  # ##       ## #
#   ##   #  #   # ##       ## #  # # #    #   ###  ###  ##  ## ## #    #      #  # #   # #   #  #  #
#  #  # #  #       #  #       ##   ##     # ## #   #    ## #    ##   #    ###  #       #   #  #    #
##   ####     #      ##         # ##    #  #    ####    #  ##  #      #       #     # ##  # #### ###
#####  #    # ###    #    #  #   #  ##S   # # #  ##      #   #     ###   #              #        # #
##  #   ##   ##    #  #   #    # # #     #          #  ###    #   # #   #  #          ##  ## ## ## #
##     # #      ##  ##    ## #  ##   ##              # ## ## #     ## #       #   #  #  #  ##  #  ##
### #      #   #  # #      ##       #  #  # #   # ##  #   ##   #     #     #     #       #### # # ##
#   #    #        #     #    #  ## # ##      # ##  #  ##    # #  #      # #         #       #   # ##
#   # ###    #      #        # #  # # #  ## #    #   #    ##    # # ####       #    #    # ##   #  #
### #     ##  #  ##    ##   # ## #    #     #    #  # #  #  #   ## ## ###   #  #   #   #  #  ###   #
# ##  # #  #  #    ##     ##  #     ###   #        ##      # #   #        # #  #  #### ##   ###    #
# #  #  #  # #  ## ###       #### #    #  ##  # ##   # ###       # # ##  # #          ## # #  ##   #
###   #  #   #   ###   ####  #   # # ###    #  #        #       #  #  ### ##   #### ####     #     #
##   # #   #  #    # ## #   ###  #      #  #   #  #  #   #    # ### #   ## #     ##  #    #  ## # ##
## #   # #       ####  # ##      #  ## #  #  ## #  #     #   ##   ## #    ##      # #      #    #  #
#   ###  # # #    #          # # # #  #      #     ### #  # # #  ###     #    ##   ## ###  #       #
#          #    ##    # #    ##    ##     #   # # # #  ## # #  ##  #    ###       # ##            ##
##        ##   ##        #          ##             # # #  #      # #         #### # #  # # ##   #  #
### ### # #  #   #   # #### #  # #     #  ###   ###     ##    #    ###       ##  #####  #  ##  #   #
#   #  ##   # # ## #      ##       #     ##    # #    ##   #       ##       ##   ####       #    # #
##     # ##  #    #####   ##     #     # # #  #  #        ###  # #            ###  # # ##   ##  # ##
#    ###  #### #      #  ###       ##   ## #   ##   # #    #######    ##  #   #### ##  ##    #######
#    ## ## #   #     #   # # ###     ##  ##    ##         #  ##   ##  # # ## # ##  # #### #        #
##    #  #  #   #  #        #      #     ###    # #    ##          # # #  ### #        # # ###   # #
####  #### #  # ##     #      ##  # # ##          ###         #  ###    ##      ##   ##     ##  ####
# #    #   #    #     ##    #              #  ##        ####  #  ###  # # ##       #   #  #  #    ##
# #      #    ##      #     ##  ##   #      # #  #        #  ##    ## # #      #   ##   # # #    # #
# #    ##      #  # ##          #  # ###   ##     #     ##   #  ## #     #  ##  #  ###    # # #    #
##   ## #### #      #    ## ## ##    ##          #  ###  ### #  # ## ##### #      # ##  ## # #  # ##
#  ##   # #     #   ##  # # # # # ##  ## ####  # #     #  ##     ####    #  #  # # #  ###      #  ##
##  ##        # #   # ###        #     #    ## #   # # ##   # # #     ##  #  #     #       # ##    #
# ##       ##        ##  #      #  #  #     #   #   #  ## #   #  #    #   # #  #  # ##  #   #  #   #
#    # # ## #     #       #   #   # ##           # #  ##    ## # ## ###    #     #  #           #  #
##      ##         #     # #    ##    #      #          #        #  #  ##      ## # #    # # # ## ##
#    #     #    #  # ##          #  #   ##  #   #     #   ####  # # #  # #     #  #    #   #  # ## #
# ##  #   ## #  #  #     #####    ### # ##   ###    #  #### #  # ##    #  # ##       ## # ##       #
#####  #   #  #        #  #     ###    ###    #         ### # #      #   #   #          #    #   # #
#    #  #    #  # ##  #      #  ##    ##    ##   #  #         # # #   ##  # # ##     #       #    ##
#        # # #  ##            ##     ## #   # #    # #  #   #    ##  ##  #   ###       #      ## # #
#    ###            #    #    ####  ###          #  #   ##   #    #    # #  ### #####       # # # ##
# #  # ## #    # ##   #     # ##  #           #  # ###  #### ##    #         # # ##   #######      #
#   #   #  # ##    ##  ###      # #     #     #  #  ##   ## #   # #####  ##   # # #    # #     #   #
#     ##    #        ##  ##   #        ##  ##   #         ##      # E # # ## #  #                # #
###  # #  ###     #    #         ###        #  #   ## #  #  #   ### ## ##   # ##  ##  ##  ##    #  #
#  ###   #   #    # #   #   #  # #        #   #  #       #  #  #  #  ###    ##   # #####  #       ##
#       ##   # ### #             # #  ####      #  ##   ##  #  ### #       ##  #     #   # # ####  #
# #  #    #     #  # # #     #   ##    ##    #### # # #    # # #   # #######    # #  #         #  ##
#       ##  #  # # #    ###   #        #        #   # #        ##       #   ## #    ##     #  ## # #
##  #### #     ## #  ##   #  #     #    # #   ##       # #  #   #  ####   #      #     #   # # ##  #
#    #  # #    # ## #   ## # ##### #  ##       # # # # ##         #   #  #  #          ## # # # #  #
## #   #   #  ###      # ##  # ##      ## #   #  # #        # ###      # ##         ## ## #    # # #
#  #   #     ## ## # # ## #    # # #  #       ## ##    #     ##     #    # # ###  # #   ## #  #  # #
# #      ####   #  ##   ###     #     ###    ###   #  ##    #   ##   ##    ###        # ##   #     #
#   ## #        #       #         ## #  #    # ##         #  ##         # #     #    ### # #     # #
#     ###  # #      #    ###   #   #  ## ### #    # #     ### #  # ## #  #     ## #       #        #
#  #  #  # ## #   #  #       #         #  #  ###     # ### ##      #       #   #    #      ### # # #
#   #  # # # ##    # ## #             ### #  #  #        #          ##              # #    # ## ## #
# # #   # ###  #  #  ### #    #   # ##  #    ##   ##             ### ##   #      #       ## # # # ##
##   #    #  #    # ###       ## # #     #  #         #         ##       #                 # ### ###
## #  # # ##      ## ##        #   #   ###   #    #  ## #   #        #    ##     ##   #  #       ###
#### ###    # ####   # ##   ## # ## #    # #      ## # #   # ##   ###  #  ## #### # #    ##### #  ##
#          #  # ##  #    #     # ### # ### #   #     ###  ###  # #    ##      #   ##  ##      ##  ##
#    ##   # ##       #     # # #      ##  #   #           # #   #   # #  #  #  #       #      #    #
####  #    # ##  #    #     #  # # # #     #      ### # ## # ## # # #     #   ##   ##   #  ######  #
#     #  # # #   # # #            # ##  #   #   # #   ##        # # #   ##  ###     # #          ###
##### #  # #      ##     ##   ###    ## #  #      # #    #    #   ##    ##  #   #     #  #       # #
#  #  #  #      ## #   ##  ###    #  #   #     # #   # # ##    # #  #   ##           #     ## # # ##
# #  #    #       #  #  ###     ###  #      # #  #  ##  ##   ##    # #   ###   #   ##   ##   #  #  #
# ###      #     #  ##    #   #   ## #  # #   ##  #        ##  ## #           #   #   #    #    ## #
##  # #  #         #  ##   # ###     #   # ###    ###   ##      #  # #      #  #  # # #         # ##
# ####   ####           # # #      #      # #     #  # #       #  #       # ## #       ##         ##
#     #   # #     ###    ##  #           ####    # # # #     # #      ###   #    #   #   #  ###  # #
##   ##  ##  # #      ##  ####   # # #    #   #     # #  ## #   # #    ###    #  # #    ##  # # #  #
# ##  #     # # ### # # #  # #    #  ##   ####    #   #   #   # #   # ## #  ##    #    #   ## ##   #
##  # #       #   #   ##  # ## ##   ##  #  #     #  #   #     #  #   ## ###  #       #  #  #       #
#  # #  ## ### #        # #  ###      #      #            ##       # #       #   #  # #       # #  #
#    ## ###  # #   ###    #     # # #  ##      ##      ##  ###   # #  #  # #     ## # ##  #  #  ## #
#  #      # ##   # ## #           # # # # #         #  # #    ### # #  #   # #  #   # #  #  ##     #
#      #     #   #  # #     # ##   # #  # ###   #  #  ## ##   #   ##    # ###     # #    ## # #    #
#       ## #  #### ## ###     ###   ##        #   # # ## ###  # ###    ## ###  #   ###   # #   #   #
# #             #   ## #   ##  #  # #   ### ##   ##   #  #  #   ##           #      # #   #  # # # #
#   #       ###  ##### #   ##     #   #    # # ##    #  # ###  # # ######  #         #  #  #   #   #
#             ##      #      # #   # #   #      #    # #        ### #     # ##     #### # # #####  #
##  #   ## #    #    #  #          #   #  #   #  ##  #  ## #  #  #    # # ## #  # # # #   #     ## #
#   #   # ##      #  #        ##  ## ###  #     #      #    ##   ###  # # #        ### #       ### #
#    #   #  #  #  #            ####  #   #   # ## #  #   #   #  #####        ###     ##     #     ##
####################################################################################################
